( ( inst
( "M10" "m10" )
( "M5" "m5" )
( "M8" "m8" )
( "M4" "m4" )
( "M2" "m2" )
( "M9" "m9" )
( "M7" "m7" )
( "M6" "m6" )
( "M1" "m1" )
( "M0" "m0" )
( "M3" "m3" )
 )
 )
