( ( inst
( "M4" "m4" )
( "M2" "m2" )
( "M1" "m1" )
( "M0" "m0" )
( "M3" "m3" )
 )
 )
